WWWWWWWWWWWWWWWWWW/
W   A            W/
W                W/
W                W/
W                W/
W                W/
W                W/
W                W/
W                W/
W                W/
W               CW/
WWWWWWWWWWWWWWWWWW/