WWWWWWWWWWWWWWWWWW/
W                W/
W                W/
W                W/
W                W/
W                W/
W      M         W/
W                W/
W                W/
W                W/
W                W/
WWWWWWWWWWWWWWWWWW/