WWWWWWWWWWWWWWWWWW/
W  B           I W/
W  W I           W/
WBWWBWWBWWBWWBWWBW/
W  W  W  W  W  W W/
W  W  W  W  W  W W/
W  W  W  W  W  W W/
W  W  W  W  W  W W/
WGLWG WGLWGDWGLW W/
WWWWWWWWWWWWWWBWBW/
WF    I          W/
WWWWWWWWWWWWWWWWWW/