WWWWWWWWWWWWWWWWWW/
W  B  H B  H  B VW/
W WWW WWW WWWWWW W/
WBW          H W W/
W W WWWWWWWWWW W W/
W W W    P  HW W W/
W WBWH       W B W/
W W WWBWWWBWWW W W/
WVWH          VW W/
WBWWBWWBWWWWWBWW W/
W B  Z         H W/
WWWWWWWWWWWWWWWWWW/